10 10
##########
#E...#####
#.##.#####
#.##.#####
#.##S....#
#.###.##.#
#.###.##.#
#...#.##.#
###......#
##########